services.mysql.auth_plugin_data	text	
services.mysql.auth_plugin_name	text	
services.mysql.capability_flags.client_can_handle_expired_passwords	boolean	
services.mysql.capability_flags.client_compress	boolean	
services.mysql.capability_flags.client_connect_attrs	boolean	
services.mysql.capability_flags.client_connect_with_db	boolean	
services.mysql.capability_flags.client_deprecated_eof	boolean	
services.mysql.capability_flags.client_found_rows	boolean	
services.mysql.capability_flags.client_ignore_sigpipe	boolean	
services.mysql.capability_flags.client_ignore_space	boolean	
services.mysql.capability_flags.client_interactive	boolean	
services.mysql.capability_flags.client_local_files	boolean	
services.mysql.capability_flags.client_long_flag	boolean	
services.mysql.capability_flags.client_long_password	boolean	
services.mysql.capability_flags.client_multi_results	boolean	
services.mysql.capability_flags.client_multi_statements	boolean	
services.mysql.capability_flags.client_no_schema	boolean	
services.mysql.capability_flags.client_odbc	boolean	
services.mysql.capability_flags.client_plugin_auth	boolean	
services.mysql.capability_flags.client_plugin_auth_len_enc_client_data	boolean	
services.mysql.capability_flags.client_protocol_41	boolean	
services.mysql.capability_flags.client_ps_multi_results	boolean	
services.mysql.capability_flags.client_reserved	boolean	
services.mysql.capability_flags.client_secure_connection	boolean	
services.mysql.capability_flags.client_session_track	boolean	
services.mysql.capability_flags.client_ssl	boolean	
services.mysql.capability_flags.client_transactions	boolean	
services.mysql.character_set	unsigned_long	
services.mysql.connection_id	unsigned_long	
services.mysql.error_code	long	
services.mysql.error_id	text	
services.mysql.error_message	text	
services.mysql.protocol_version	unsigned_long	
services.mysql.server_version	text	
services.mysql.status_flags.server_more_results_exists	boolean	
services.mysql.status_flags.server_ps_out_params	boolean	
services.mysql.status_flags.server_query_no_good_index_used	boolean	
services.mysql.status_flags.server_query_no_index_used	boolean	
services.mysql.status_flags.server_query_was_slow	boolean	
services.mysql.status_flags.server_session_state_changed	boolean	
services.mysql.status_flags.server_status_autocommit	boolean	
services.mysql.status_flags.server_status_cursor_exists	boolean	
services.mysql.status_flags.server_status_db_dropped	boolean	
services.mysql.status_flags.server_status_in_trans	boolean	
services.mysql.status_flags.server_status_in_trans_readonly	boolean	
services.mysql.status_flags.server_status_last_row_sent	boolean	
services.mysql.status_flags.server_status_metadata_changed	boolean	
services.mysql.status_flags.server_status_no_backslash_escapes	boolean
